                                        
                                        
WWWWWWWWWWWWWWWWWWWWWWWWWWWWWWWWWWWWWWWW
WF                 W                  FW
W                  W                   W
W  WWWW  WWWWWWWW  W  WWWWWWWW  WWWWW  W
W  W  W  W  W             W  W  W  WW  W
W  W  W  W  W             W  W  W  WW  W
W  WWWW  WWWW  WWWWWWWWW..WWWW  WWWWW  W
W                  W                   W
W                  W                   W
W  WWWW  WWWWWWWW  W  WWWWWWWW  WWWW   W
W           W      W                   W
W           W      M      W            W
WWWWWWWWWW                   WWWWWWWWWWW
         W                   W          
         W                   W          
         W                   W          
         W                   W          
WWWWWWWWWW                   WWWWWWWWWWW
W                                      W
W                                      W
W                                      W
W.....W............J............W......W
W                                      W
W                                      W
W                                      W
W                                      W
W                                      W
W                                      W
W                                      W
WWWWWWWWWWWWWWWWWWWWWWWWWWWWWWWWWWWWWWWW